*^.^~****^*~~.~^~..~~~^~.^~.*~**.^^*^*^~..*^^..~^.
*.*~*.~^^^~~.*~*.**.~~^*^**.^~*^^.*^...^..^.**.~^*
^^***~.*^*^..^**.~~~.~*.~^^~^~^.^~^*~**.~*^.^**.*.
*~~.~^.~*~^~^^*^**.~.*^^*~~^^*~.^.*^^*^.^.~~^^^*~.
*.^~^^.~^.^.^^*~^~~*^..^~^~~^.*^^..**.**~.~~^~*~**
^.^^~^.*~**.*~*^*~^*~~^.^.~.~^**~.^^^^*.~.~~~^^.^.
*~~.*.^~~~^*.^*~~~*^.^**^*^.^.^~~***^^*^.~^^.^^.~.
.~.*~~^*.**.~^^~**^.^.^~~~^.~.^~~^^.~^^.^^~.~.~.*^
.^^^~~*~.^.~.*~.~~..~*~^.~**~..^****~.*~^~~*~**^~^
^^^*^^**...*.^^*^^^.*~*~^^~*~~.~****~~~~***.^^~~^~
..*^^^^^.^~.^~.^.^^~*~^*~**^*^.~~~*^.^^~**~*~.....
**.^~~~^~*~****.**^~.^.*^^^~.^...~.**^^^^~^.~^~.~*
^*~.*.~*^.~.^^^^^*~.**~^.*^*.~~..^~~~*~*^.~~^*^*^^
~*^.^..**~**^*^~***^~~*^*.*~..~^^***^.*~.^*^^^^.~.
*~^~^**^^*^^~^*~^^*~~~*^*~~~~*~^^^*~..~~~~~.*~^~*.
^.*.^*^**^^^~**.*.~^~~~^..~~~*~~^*~..^^.^~*.^~^~**
.***^..*^~~~~^~.*^~~.*.~^.^^*.***^~^.*....~.^.*~^^
^^~~~~.**.*.^^*.^~~^....*~*^~*^^.^~~~^*.~^^^~**^~~
^~~*^*.~.*^^^*^.*..~*...~**^.^^~.^^.^..^.^**.^^..*
~^***~^.~.~^^^*~~~.*..^~^^.~^.~.**...~^~**~^~~**^~
~~~^~.^*.^*.~*.*~~^..~*^^~~**.*.*.~^^^..^.~^.*.^~~
^^~...^.*~.^^**~^~*..^~^~*....^.^^**~.*.^^*..~*~.*
^..^...~.~.*.~***~*~~*..~*~^^~~^~**^~~^*^^~*.~*^*^
*^.**^~*****.~~~..~^~.*.^*~^.^^*^..*~^.^.^*.^.~^^*
~...~*^....*^.*^^*...^.~~..^.*~.*~.*^.^*^*^.****^~
^..~***^.*^~~.****.~*^.~.^~*.~^*^~^.****~..~*..*^~
.~^~**~^^..~~~^..*~*.^**~..^^*.~.*..*~~*~.^~.~*~~.
.***~..~**^.~.~.~*.~~**..^.^~..~*~~~~*.**~~^..^.^^
~.*.~^*^*~^.~*..*~^~~.*.*..*.*..^~.*~^^*.~^.^~^**^
.*^~^^*.^*.~*...*~~~*.**.~...*.*^.^*.^*~*.^~^**^*.
.~..*....~..~.***~..~^..~~^*^*^~^^~~**^.*~**^**^^*
^.*.~.^.**^*^.~^^*.~..*^~*^***.~**..^.~~*..^*^~*.~
^~~^~~*.~^^~~^**.^.^^^*^.*^^~~.^.*~^*^^..**..**..^
^.^*.*^..*.~~.^^***^.*~..~.**^*.~^...^^~*.~^~^..~~
~^^.^..*^^.**.~~^*~*^~*~^~~.~*.^~.~*^~*.*..^.^^*^*
^^.~*^~~*.~~*~.^..~*.^.~**.^*^.^~.**.~*.~...~~..*.
.~..^.~.~.^*.~^*~.~.*^*~~*.^.******~*~~*^~~~^.~~*~
~.*..^^*^~*.~~.~.^~..~.~^^^.*~*.**~^*~*^*^^~..^~^^
*.^*^**^*.^^*....**..~^^~.^*^.*~*^**^^..*.^^*^^^.~
^*^~^^*.~*~^*~^~~.*.^*^~*^^~.*~.*~.**.*~^~~.~*^~~*
~~**~*.^.*~..~~^^^~^^^.~***^*.^*~^*~^~*~**...~..~@
*~**^~~.^.*.~^**~*^^.*^*.^~~*~~~*^.*..~~^*^.*^.^.*
.*^~..*~.*^^^^^~~^^*.~*.~~~.***~^.*..~~******~~^*.
.^^..^.^*^~^.~*...**~~~.**^*~~~*^***~^*^~^~~^^^*.*
**.**~.**~.*.*^~~.~^.*^.~~*.^*.~.***~*^^..~*.~*^*^
~..^.****^.****~^~***..^^^^*^.~*^^*.~~.^**^*~^*.~~
^*~^.~*...^^.^~.^^..~^...**...^****^*~*~*^..~^*~.~
...^~^.~^^~~~~.*^~.^~***~~^^^.*^^.~.^*~*~**^***^~^
.~~~~~^^.~~*^.~^^^**~^~.^~^~*..^*~^^*..*~^~**.*.^.
~^**.~**..*^~^^^.^*^~^~*^.~*~.^.**.^.^^.~**^~~^~^X
